"aa" = (/turf/open/space/basic,/turf/template_noop,/area/template_noop)
"ab" = (/turf/open/space/basic,/area/shuttle/escape)
"ac" = (/obj/effect/decal/cleanable/dirt,/obj/structure/closet,/obj/item/restraints/handcuffs/cable,/obj/item/melee/baton/cattleprod,/turf/open/floor/plating/astplate,/area/shuttle/escape)
"ad" = (/turf/closed/wall/rust,/area/shuttle/escape)
"ae" = (/obj/structure/window{dir = 4},/mob/living/simple_animal/bot/honkbot,/turf/open/floor/plating/astplate,/area/shuttle/escape)
"af" = (/obj/effect/decal/cleanable/dirt,/obj/item/restraints/handcuffs/cable/zipties/used,/obj/effect/decal/cleanable/cobweb,/turf/open/floor/plating/astplate,/area/shuttle/escape)
"ag" = (/turf/open/floor/plating/astplate,/area/shuttle/escape)
"ah" = (/obj/machinery/computer/emergency_shuttle,/obj/structure/spider/stickyweb,/turf/open/floor/plating/astplate,/area/shuttle/escape)
"ai" = (/obj/effect/decal/cleanable/dirt,/obj/effect/decal/remains/xeno,/turf/open/floor/plating/astplate,/area/shuttle/escape)
"aj" = (/obj/effect/decal/cleanable/vomit/old,/obj/structure/spider/stickyweb,/turf/open/floor/plating/astplate,/area/shuttle/escape)
"ak" = (/obj/structure/window{dir = 4},/obj/effect/decal/cleanable/dirt,/obj/item/stock_parts/cell,/turf/open/floor/plating/astplate,/area/shuttle/escape)
"al" = (/turf/closed/wall,/area/shuttle/escape)
"am" = (/obj/structure/lattice/catwalk,/obj/vehicle/bicycle,/turf/open/space/basic,/area/shuttle/escape)
"an" = (/obj/item/ammo_casing/shotgun/rubbershot,/obj/effect/decal/cleanable/dirt,/obj/effect/decal/cleanable/blood/gibs/limb,/turf/open/floor/plating/astplate,/area/shuttle/escape)
"ao" = (/obj/structure/lattice,/turf/open/space/basic,/area/shuttle/escape)
"ap" = (/obj/structure/grille,/obj/structure/window/fulltile,/turf/open/floor/plating/astplate,/area/shuttle/escape)
"aq" = (/obj/structure/grille/broken,/obj/structure/window{dir = 4},/obj/structure/window,/obj/structure/barricade/wooden,/turf/open/floor/plating/astplate,/area/shuttle/escape)
"ar" = (/obj/machinery/door/firedoor/closed,/turf/open/floor/plating/astplate,/area/shuttle/escape)
"as" = (/obj/effect/decal/cleanable/blood/tracks{dir = 4},/turf/open/floor/plating/astplate,/area/shuttle/escape)
"at" = (/obj/structure/window/reinforced{dir = 1},/obj/structure/table/wood/poker,/obj/item/storage/wallet,/obj/item/coin/iron,/turf/open/floor/plating/astplate,/area/shuttle/escape)
"au" = (/obj/effect/decal/cleanable/blood/tracks,/turf/open/floor/plating/astplate,/area/shuttle/escape)
"av" = (/obj/machinery/door/firedoor/closed,/turf/open/space/basic,/area/shuttle/escape)
"aw" = (/obj/effect/decal/cleanable/dirt,/turf/open/floor/plating/astplate,/area/shuttle/escape)
"ax" = (/obj/structure/spacevine,/obj/effect/decal/cleanable/dirt,/turf/open/floor/plating/astplate,/area/shuttle/escape)
"ay" = (/obj/structure/shuttle/engine/heater,/obj/structure/window{dir = 1},/obj/structure/window{dir = 8},/turf/open/floor/plating/astplate,/area/shuttle/escape)
"az" = (/obj/structure/shuttle/engine/heater,/obj/structure/window{dir = 1},/turf/open/floor/plating/astplate,/area/shuttle/escape)
"aA" = (/obj/structure/shuttle/engine/heater,/obj/structure/window{dir = 4},/obj/structure/window{dir = 1},/turf/open/floor/plating/astplate,/area/shuttle/escape)
"aB" = (/obj/structure/grille,/obj/structure/window/reinforced{dir = 1},/turf/open/floor/plating/astplate,/area/shuttle/escape)
"aC" = (/obj/item/broken_bottle,/turf/open/floor/plating/astplate,/area/shuttle/escape)
"aD" = (/obj/structure/window{dir = 8},/turf/open/floor/plating/astplate,/area/shuttle/escape)
"aE" = (/obj/structure/window{dir = 4},/turf/open/floor/plating/astplate,/area/shuttle/escape)
"aF" = (/obj/structure/shuttle/engine/huge,/turf/open/space/basic,/area/shuttle/escape)
"aG" = (/obj/structure/chair{dir = 4},/turf/open/floor/plating/astplate,/area/shuttle/escape)
"aH" = (/obj/effect/decal/cleanable/dirt,/mob/living/simple_animal/hostile/lizard,/turf/open/floor/plating/astplate,/area/shuttle/escape)
"aI" = (/obj/effect/decal/cleanable/dirt,/obj/item/twohanded/fireaxe,/turf/open/floor/plating/astplate,/area/shuttle/escape)
"aJ" = (/obj/structure/table/wood/poker,/obj/item/gun/ballistic/revolver/russian,/turf/open/floor/plating/astplate,/area/shuttle/escape)
"aK" = (/obj/item/chair,/turf/open/floor/plating/astplate,/area/shuttle/escape)
"aL" = (/obj/item/device/flashlight/flare,/obj/machinery/light/small,/turf/open/floor/plating/astplate,/area/shuttle/escape)
"aM" = (/obj/structure/window/reinforced{dir = 4},/obj/item/ore/glass,/turf/open/floor/plating/astplate,/area/shuttle/escape)
"aN" = (/obj/structure/chair{dir = 4},/obj/item/trash/sosjerky,/turf/open/floor/plating/astplate,/area/shuttle/escape)
"aO" = (/obj/structure/grille/broken,/obj/structure/window/reinforced{dir = 4},/obj/item/shard,/obj/item/stack/rods{amount = 2},/obj/structure/window{dir = 1},/obj/effect/decal/cleanable/ash,/obj/effect/decal/cleanable/vomit/old,/obj/effect/decal/cleanable/dirt,/obj/item/shard,/turf/open/floor/plating/astplate,/area/shuttle/escape)
"aP" = (/obj/structure/spider/cocoon,/turf/open/floor/plating/astplate,/area/shuttle/escape)
"aQ" = (/obj/effect/decal/cleanable/dirt,/obj/item/device/flashlight,/obj/effect/decal/cleanable/blood/old,/turf/open/floor/plating/astplate,/area/shuttle/escape)
"aR" = (/obj/item/chair,/obj/item/cigbutt,/turf/open/floor/plating/astplate,/area/shuttle/escape)
"aS" = (/obj/structure/lattice/catwalk,/obj/item/chair,/turf/open/space/basic,/area/shuttle/escape)
"aT" = (/obj/item/rack_parts,/obj/item/clothing/mask/gas,/obj/item/c_tube,/obj/structure/sign/poster/contraband/random{pixel_y = 32},/turf/open/floor/plating/astplate,/area/shuttle/escape)
"aU" = (/obj/effect/decal/cleanable/oil,/obj/effect/decal/cleanable/dirt,/obj/item/cigbutt/roach,/turf/open/floor/plating/astplate,/area/shuttle/escape)
"aV" = (/obj/machinery/door/firedoor,/turf/open/floor/plating/astplate,/area/shuttle/escape)
"aW" = (/obj/structure/window{dir = 4},/obj/machinery/portable_atmospherics/canister/air,/turf/open/floor/plating/astplate,/area/shuttle/escape)
"aX" = (/obj/structure/grille/broken,/obj/structure/window/fulltile,/turf/open/floor/plating/astplate,/area/shuttle/escape)
"aY" = (/obj/item/wirerod,/turf/open/floor/plating/astplate,/area/shuttle/escape)
"aZ" = (/obj/structure/barricade/wooden,/obj/structure/window/fulltile/unanchored,/turf/open/floor/plating/astplate,/area/shuttle/escape)
"ba" = (/obj/effect/decal/cleanable/dirt,/obj/effect/decal/cleanable/blood/gibs/old,/obj/structure/spider/stickyweb,/turf/open/floor/plating/astplate,/area/shuttle/escape)
"bb" = (/obj/effect/decal/cleanable/dirt,/obj/effect/decal/cleanable/blood/gibs/old,/turf/open/floor/plating/astplate,/area/shuttle/escape)
"bc" = (/obj/structure/window/reinforced{dir = 1},/turf/open/floor/plating/astplate,/area/shuttle/escape)
"bd" = (/obj/structure/window{dir = 1},/obj/effect/decal/cleanable/dirt,/turf/open/floor/plating/astplate,/area/shuttle/escape)
"be" = (/obj/effect/particle_effect/foam/metal/iron,/turf/open/floor/plating/astplate,/area/shuttle/escape)
"bf" = (/obj/structure/window{dir = 1},/obj/machinery/vending/sovietsoda,/turf/open/floor/plating/astplate,/area/shuttle/escape)
"bg" = (/obj/item/ammo_casing/shotgun/rubbershot,/turf/open/floor/plating/astplate,/area/shuttle/escape)
"bh" = (/obj/structure/grille,/obj/structure/window{dir = 8},/obj/structure/window{dir = 1},/obj/structure/window,/obj/item/shard,/turf/open/floor/plating/astplate,/area/shuttle/escape)
"bi" = (/obj/structure/window/reinforced{dir = 1},/obj/effect/decal/cleanable/ash/large,/turf/open/floor/plating/astplate,/area/shuttle/escape)
"bj" = (/obj/item/ore/glass,/turf/open/floor/plating/astplate,/area/shuttle/escape)
"bk" = (/obj/item/chair,/obj/item/broken_bottle,/turf/open/floor/plating/astplate,/area/shuttle/escape)
"bl" = (/obj/item/stack/sheet/metal,/obj/item/light/tube/broken,/turf/open/floor/plating/astplate,/area/shuttle/escape)
"bm" = (/obj/effect/decal/cleanable/cobweb,/obj/structure/rack,/obj/item/storage/toolbox/mechanical/old,/obj/item/cautery,/turf/open/floor/plating/astplate,/area/shuttle/escape)
"bn" = (/obj/structure/chair{dir = 4},/obj/item/ammo_casing/shotgun/beanbag,/obj/structure/window{dir = 8},/turf/open/floor/plating/astplate,/area/shuttle/escape)
"bo" = (/obj/structure/lattice,/obj/structure/grille/broken,/turf/open/space/basic,/area/shuttle/escape)
"bp" = (/obj/item/shard,/obj/item/stack/rods,/obj/item/chair,/obj/effect/decal/cleanable/blood/tracks,/turf/open/floor/plating/astplate,/area/shuttle/escape)
"bq" = (/obj/effect/decal/cleanable/dirt,/obj/effect/decal/cleanable/salt{desc = "Кто-то здесь очень сильно передергивал..."; name = "sperma"},/turf/open/floor/plating/astplate,/area/shuttle/escape)
"br" = (/obj/effect/decal/cleanable/blood/tracks,/obj/structure/sign/poster/contraband/kudzu{pixel_x = 32},/turf/open/floor/plating/astplate,/area/shuttle/escape)
"bs" = (/obj/structure/chair/stool,/obj/effect/decal/cleanable/dirt,/turf/open/floor/plating/astplate,/area/shuttle/escape)
"bt" = (/obj/structure/spider/cocoon,/obj/effect/decal/cleanable/dirt,/turf/open/floor/plating/astplate,/area/shuttle/escape)
"bu" = (/obj/structure/lattice/catwalk,/obj/structure/chair/old,/turf/open/space/basic,/area/shuttle/escape)
"bv" = (/obj/structure/lattice/catwalk,/turf/open/space/basic,/area/shuttle/escape)
"bw" = (/obj/effect/decal/cleanable/blood,/obj/effect/decal/cleanable/blood{pixel_x = 8; pixel_y = 16},/obj/item/bodypart/r_leg,/obj/item/bodypart/r_arm{pixel_x = -8; pixel_y = 8},/obj/effect/decal/cleanable/blood/gibs/old,/turf/open/floor/plating/astplate,/area/shuttle/escape)
"bx" = (/obj/machinery/door/firedoor/closed,/obj/docking_port/mobile/emergency{name = "Govno emergency shuttle"},/turf/open/floor/plating/astplate,/area/shuttle/escape)
"by" = (/obj/item/ammo_casing/shotgun/rubbershot,/obj/structure/rack,/obj/item/firstaid_arm_assembly,/turf/open/floor/plating/astplate,/area/shuttle/escape)
"bz" = (/obj/structure/barricade/sandbags,/turf/open/floor/plating/astplate,/area/shuttle/escape)
"bA" = (/obj/effect/decal/cleanable/dirt,/obj/structure/barricade/sandbags,/turf/open/floor/plating/astplate,/area/shuttle/escape)
"bB" = (/obj/item/weaponcrafting/stock,/obj/structure/firelock_frame,/turf/open/floor/plating/astplate,/area/shuttle/escape)
"bC" = (/obj/effect/decal/cleanable/blood/xtracks,/obj/effect/decal/cleanable/ash,/turf/open/floor/plating/astplate,/area/shuttle/escape)
"bD" = (/obj/effect/decal/cleanable/dirt,/obj/item/chair,/turf/open/floor/plating/astplate,/area/shuttle/escape)
"bE" = (/obj/effect/decal/cleanable/dirt,/obj/effect/decal/cleanable/ash,/obj/structure/sink{pixel_y = 28},/turf/open/floor/plating/astplate,/area/shuttle/escape)
"bF" = (/obj/machinery/computer/security/wooden_tv,/turf/open/floor/plating/astplate,/area/shuttle/escape)
"bG" = (/obj/item/broken_bottle,/obj/structure/toilet{desc = "Заблеванна\roman[] грна\green и вонюча\green параша"; name = "Parasha"; pixel_y = 16},/obj/effect/decal/cleanable/vomit/old,/obj/effect/decal/cleanable/dirt,/turf/open/floor/plating/astplate,/area/shuttle/escape)
"bH" = (/obj/item/shard,/obj/effect/decal/cleanable/dirt,/obj/structure/sink{pixel_y = 28},/turf/open/floor/plating/astplate,/area/shuttle/escape)
"bI" = (/obj/structure/closet/cardboard,/turf/open/floor/plating/astplate,/area/shuttle/escape)
"bJ" = (/obj/item/trash/raisins,/turf/open/floor/plating/astplate,/area/shuttle/escape)
"bK" = (/obj/item/ammo_casing/shotgun/beanbag,/obj/effect/decal/cleanable/dirt,/obj/machinery/light/small/built,/turf/open/floor/plating/astplate,/area/shuttle/escape)
"bL" = (/obj/item/trash/cheesie,/obj/effect/decal/cleanable/dirt,/obj/effect/decal/cleanable/salt{desc = "Кто-то здесь очень сильно передергивал..."; name = "sperma"},/turf/open/floor/plating/astplate,/area/shuttle/escape)
"bM" = (/obj/structure/chair/stool,/turf/open/floor/plating/astplate,/area/shuttle/escape)
"bN" = (/obj/item/chair/stool,/turf/open/floor/plating/astplate,/area/shuttle/escape)
"bO" = (/obj/structure/table_frame,/obj/item/shard,/obj/effect/decal/remains/xeno/larva,/turf/open/floor/plating/astplate,/area/shuttle/escape)
"bP" = (/obj/item/device/flashlight/flare/torch,/obj/effect/decal/cleanable/dirt,/turf/open/floor/plating/astplate,/area/shuttle/escape)
"bQ" = (/obj/structure/spider/stickyweb,/obj/effect/decal/cleanable/dirt,/turf/open/floor/plating/astplate,/area/shuttle/escape)
"bR" = (/obj/structure/spirit_board,/turf/open/floor/plating/astplate,/area/shuttle/escape)
"bS" = (/obj/effect/decal/cleanable/dirt,/obj/structure/chair{dir = 8},/turf/open/floor/plating/astplate,/area/shuttle/escape)
"bT" = (/obj/item/chair,/obj/structure/window{dir = 4},/obj/effect/decal/cleanable/dirt,/turf/open/floor/plating/astplate,/area/shuttle/escape)
"bU" = (/obj/structure/barricade/wooden,/turf/open/floor/plating/astplate,/area/shuttle/escape)
"bV" = (/obj/structure/window,/turf/open/floor/plating/astplate,/area/shuttle/escape)
"bW" = (/obj/item/cigbutt,/obj/effect/decal/cleanable/dirt,/obj/structure/chair{dir = 4},/obj/machinery/light/small{brightness = 3; dir = 8},/turf/open/floor/plating/astplate,/area/shuttle/escape)
"bX" = (/obj/structure/chair{dir = 8},/obj/structure/sign/poster/contraband/Gymposter_1{pixel_x = 32},/turf/open/floor/plating/astplate,/area/shuttle/escape)
"bY" = (/obj/structure/barricade/wooden,/obj/structure/window{dir = 1},/turf/open/floor/plating/astplate,/area/shuttle/escape)
"bZ" = (/obj/item/chair/stool,/obj/item/shard,/obj/effect/decal/cleanable/dirt,/obj/effect/decal/cleanable/dirt,/obj/effect/decal/cleanable/blood/xtracks{dir = 5},/turf/open/floor/plating/astplate,/area/shuttle/escape)
"ca" = (/obj/structure/spider/cocoon,/obj/structure/spider/stickyweb,/turf/open/floor/plating/astplate,/area/shuttle/escape)
"cb" = (/obj/item/chair,/obj/structure/window{dir = 8},/turf/open/floor/plating/astplate,/area/shuttle/escape)
"cc" = (/obj/item/device/flashlight/flare,/turf/open/floor/plating/astplate,/area/shuttle/escape)
"cd" = (/obj/structure/barricade/wooden,/obj/structure/window/reinforced{dir = 4},/obj/structure/window{dir = 8},/obj/structure/window{dir = 1},/turf/open/floor/plating/astplate,/area/shuttle/escape)
"ce" = (/obj/structure/barricade/wooden,/obj/structure/window/fulltile,/turf/open/floor/plating/astplate,/area/shuttle/escape)
"cf" = (/obj/item/device/flashlight/flare,/obj/effect/decal/cleanable/dirt,/obj/effect/decal/cleanable/dirt,/turf/open/floor/plating/astplate,/area/shuttle/escape)
"cg" = (/obj/structure/table,/obj/item/crowbar/large,/turf/open/floor/plating/astplate,/area/shuttle/escape)
"ch" = (/obj/structure/chair/stool,/obj/effect/decal/cleanable/dirt,/obj/effect/decal/cleanable/dirt,/turf/open/floor/plating/astplate,/area/shuttle/escape)
"ci" = (/obj/structure/barricade/wooden,/obj/structure/window{dir = 1},/obj/effect/decal/cleanable/blood/xtracks,/turf/open/floor/plating/astplate,/area/shuttle/escape)
"cj" = (/obj/structure/barricade/wooden,/obj/structure/window{dir = 8},/obj/structure/window{dir = 4},/turf/open/floor/plating/astplate,/area/shuttle/escape)
"ck" = (/obj/item/stack/sheet/metal,/obj/structure/sign/poster/contraband/Gymposter_2{pixel_x = 32},/turf/open/floor/plating/astplate,/area/shuttle/escape)
"cl" = (/obj/effect/decal/cleanable/dirt,/obj/effect/decal/cleanable/dirt,/turf/open/floor/plating/astplate,/area/shuttle/escape)
"cm" = (/obj/structure/spider/stickyweb,/obj/item/device/flashlight,/turf/open/floor/plating/astplate,/area/shuttle/escape)
"cn" = (/obj/item/restraints/handcuffs/cable/zipties/used,/turf/open/floor/plating/astplate,/area/shuttle/escape)
"co" = (/obj/structure/rack,/obj/item/storage/toolbox/emergency/old,/obj/item/tank/internals/emergency_oxygen,/turf/open/floor/plating/astplate,/area/shuttle/escape)
"cp" = (/obj/item/rack_parts,/obj/structure/extinguisher_cabinet{pixel_y = 32},/obj/item/tank/internals/emergency_oxygen,/obj/item/clothing/mask/gas,/turf/open/floor/plating/astplate,/area/shuttle/escape)
"cq" = (/obj/structure/sign/enginesafety,/turf/closed/wall/rust,/area/shuttle/escape)
"cr" = (/obj/structure/chair{dir = 8},/turf/open/floor/plating/astplate,/area/shuttle/escape)
"cs" = (/obj/item/cigbutt,/obj/effect/decal/cleanable/dirt,/turf/open/floor/plating/astplate,/area/shuttle/escape)
"ct" = (/obj/item/statuebust,/turf/open/floor/plating/astplate,/area/shuttle/escape)
"cu" = (/obj/effect/decal/cleanable/blood,/turf/open/floor/plating/astplate,/area/shuttle/escape)
"cv" = (/obj/machinery/door/firedoor,/obj/effect/decal/cleanable/blood/tracks{dir = 4},/turf/open/floor/plating/astplate,/area/shuttle/escape)
"cw" = (/obj/structure/firelock_frame,/obj/effect/decal/cleanable/blood/tracks{dir = 4},/obj/effect/particle_effect/foam/metal/resin,/turf/open/floor/plating/astplate,/area/shuttle/escape)
"cx" = (/obj/item/cigbutt,/turf/open/floor/plating/astplate,/area/shuttle/escape)
"cy" = (/obj/structure/barricade/wooden,/obj/structure/window{dir = 4},/obj/item/shard,/obj/item/stack/rods,/turf/open/floor/plating/astplate,/area/shuttle/escape)
"cz" = (/obj/effect/decal/cleanable/dirt,/obj/effect/decal/cleanable/blood/tracks{dir = 4},/turf/open/floor/plating/astplate,/area/shuttle/escape)
"cA" = (/obj/effect/decal/cleanable/blood/tracks{dir = 6},/turf/open/floor/plating/astplate,/area/shuttle/escape)
"cB" = (/obj/machinery/vending/boyarka{pixel_x = 32},/obj/effect/decal/cleanable/dirt,/turf/open/floor/plating/astplate,/area/shuttle/escape)
"cC" = (/obj/effect/decal/cleanable/dirt,/obj/effect/decal/cleanable/shreds,/turf/open/floor/plating/astplate,/area/shuttle/escape)
"cD" = (/obj/structure/spider/stickyweb,/obj/structure/sign/poster/contraband/rebels_unite{pixel_y = 32},/turf/open/floor/plating/astplate,/area/shuttle/escape)
"cE" = (/obj/item/cigbutt,/obj/item/device/flashlight/flare/torch,/obj/structure/table,/obj/item/reagent_containers/glass/bottle/toxin,/obj/structure/spider/stickyweb,/obj/item/kitchen/knife,/turf/open/floor/plating/astplate,/area/shuttle/escape)
"cF" = (/obj/structure/table,/obj/item/reagent_containers/food/drinks/boyarishnik{pixel_x = 4; pixel_y = 4},/obj/item/reagent_containers/food/drinks/boyarishnik{pixel_x = -4; pixel_y = 4},/obj/item/reagent_containers/food/drinks/boyarishnik,/obj/item/reagent_containers/food/drinks/drinkingglass,/turf/open/floor/plating/astplate,/area/shuttle/escape)
"cG" = (/obj/effect/decal/cleanable/blood/tracks{dir = 4},/obj/item/ore/glass,/turf/open/floor/plating/astplate,/area/shuttle/escape)
"cH" = (/obj/structure/grille/broken,/turf/open/floor/plating/astplate,/area/shuttle/escape)
"cI" = (/obj/effect/decal/cleanable/dirt,/obj/structure/closet/crate/trashcart,/turf/open/floor/plating/astplate,/area/shuttle/escape)
"cJ" = (/obj/structure/bonfire,/obj/effect/decal/cleanable/dirt,/turf/open/floor/plating/astplate,/area/shuttle/escape)
"cK" = (/obj/item/restraints/handcuffs/cable/zipties/used,/obj/effect/decal/cleanable/dirt,/turf/open/floor/plating/astplate,/area/shuttle/escape)
"cL" = (/obj/structure/lattice,/obj/structure/grille,/turf/open/space/basic,/area/shuttle/escape)
"cM" = (/obj/structure/barricade/wooden,/obj/structure/spider/stickyweb,/turf/open/floor/plating/astplate,/area/shuttle/escape)
"cN" = (/obj/item/device/flashlight/flare/torch,/turf/open/floor/plating/astplate,/area/shuttle/escape)
"cO" = (/obj/structure/grille/broken,/obj/structure/spider/stickyweb,/turf/open/floor/plating/astplate,/area/shuttle/escape)
"cP" = (/obj/structure/flora/tree/jungle/small,/turf/open/floor/plating/astplate,/area/shuttle/escape)
"cQ" = (/obj/item/soap/homemade,/obj/structure/toilet{desc = "Заблеванна\roman[] грна\green и вонюча\green параша"; name = "Parasha"; pixel_y = 16},/obj/effect/decal/cleanable/dirt,/obj/effect/decal/cleanable/blood/old,/obj/effect/decal/cleanable/cobweb,/turf/open/floor/plating/astplate,/area/shuttle/escape)
"cR" = (/obj/structure/bed,/obj/effect/decal/cleanable/dirt,/obj/effect/decal/cleanable/dirt,/obj/effect/decal/cleanable/shreds,/turf/open/floor/plating/astplate,/area/shuttle/escape)
"cS" = (/obj/item/weaponcrafting/receiver,/obj/effect/decal/cleanable/blood/gibs/old,/obj/structure/curtain,/obj/structure/spider/stickyweb,/obj/effect/decal/cleanable/dirt,/obj/effect/decal/cleanable/dirt,/turf/open/floor/plating/astplate,/area/shuttle/escape)
"cT" = (/obj/structure/sign/fire{pixel_y = -32},/turf/open/floor/plating/astplate,/area/shuttle/escape)
"cU" = (/obj/item/chair,/obj/effect/decal/cleanable/dirt,/turf/open/floor/plating/astplate,/area/shuttle/escape)
"cV" = (/obj/effect/decal/cleanable/ash,/turf/open/floor/plating/astplate,/area/shuttle/escape)
"cW" = (/obj/structure/grille/broken,/obj/structure/firelock_frame,/turf/open/floor/plating/astplate,/area/shuttle/escape)
"cX" = (/obj/effect/decal/cleanable/dirt,/obj/item/kitchen/fork,/obj/effect/decal/cleanable/ash,/turf/open/floor/plating/astplate,/area/shuttle/escape)
"cY" = (/obj/item/trash/popcorn,/obj/effect/decal/cleanable/blood/gibs/old,/turf/open/floor/plating/astplate,/area/shuttle/escape)
"cZ" = (/obj/effect/decal/cleanable/dirt,/obj/item/light/bulb/broken,/obj/effect/decal/remains/human,/obj/machinery/light/small{dir = 4},/turf/open/floor/plating/astplate,/area/shuttle/escape)
"da" = (/obj/item/trash/candy,/obj/effect/decal/cleanable/dirt,/turf/open/floor/plating/astplate,/area/shuttle/escape)
"db" = (/obj/effect/decal/cleanable/dirt,/obj/item/broken_bottle,/obj/structure/toilet{desc = "Заблеванна\roman[] грна\green и вонюча\green параша"; name = "Parasha"; pixel_y = 16},/obj/effect/decal/cleanable/vomit/old,/turf/open/floor/plating/astplate,/area/shuttle/escape)
"dc" = (/obj/effect/decal/cleanable/blood/tracks{dir = 4},/obj/effect/decal/cleanable/dirt,/turf/open/floor/plating/astplate,/area/shuttle/escape)
"dd" = (/obj/effect/decal/cleanable/blood/tracks{dir = 5},/obj/effect/decal/cleanable/dirt,/turf/open/floor/plating/astplate,/area/shuttle/escape)
"df" = (/obj/structure/table_frame,/obj/item/stack/rods,/obj/item/clothing/gloves/color/fyellow/old,/turf/open/floor/plating/astplate,/area/shuttle/escape)
"di" = (/obj/item/device/flashlight/flare,/obj/effect/decal/cleanable/dirt,/turf/open/floor/plating/astplate,/area/shuttle/escape)
"dj" = (/obj/structure/table_frame,/obj/item/stack/sheet/metal,/obj/structure/grille/broken,/obj/item/flamethrower,/obj/item/coin/iron,/turf/open/floor/plating/astplate,/area/shuttle/escape)
"dl" = (/obj/structure/disposalpipe/segment,/turf/closed/wall/rust,/area/shuttle/escape)
"do" = (/obj/structure/closet/cardboard,/obj/machinery/light/small{dir = 4},/turf/open/floor/plating/astplate,/area/shuttle/escape)
"dp" = (/obj/effect/decal/cleanable/dirt,/obj/item/ore/glass,/turf/open/floor/plating/astplate,/area/shuttle/escape)
"dr" = (/obj/item/stack/sheet/metal,/obj/structure/disposalpipe/trunk{dir = 1},/obj/machinery/disposal/bin,/turf/open/floor/plating/astplate,/area/shuttle/escape)
"ds" = (/obj/structure/sign/deathsposal{pixel_y = 32},/turf/open/floor/plating/astplate,/area/shuttle/escape)
"du" = (/obj/effect/decal/cleanable/blood/tracks{dir = 4},/obj/structure/sign/poster/contraband/communist_state{name = "CCCP"; pixel_y = 32},/turf/open/floor/plating/astplate,/area/shuttle/escape)

(1,1,1) = {"
aaaaaaaaaaaaaaaaaaaaaaaaaaaaaaaaaaaaaaaaaaaa
aaaladaBaXaqaBaXadaladadadalbeadaaaaaaaaaaaa
aaadahbFbcataJbdbjctacaeafaiajadaocLaaaaaaaa
aabeagbsawbMbNagbtawccakanaxaIbeaaboaaaaaaaa
aabebQbgawagaKbRbNagagaMaPaQagbeaacLaaaaaaaa
aabebZbVcaaLaHchagawagaWbaawbbadaacLaaaaaaaa
aladcibYadadadadcqaVbUbUbfbibpbeaoaoaoboaaaa
arcmbCcocpaTaZbmbyawadbqagawbradaabubvcLaaaa
bhawagagagcucvascGascwasasascAadadadaladaaaa
bxasczczczcAbUcCbDcBadbzbAagagbBbEbGbHbUaaaa
adadaGccagcrbUcEcFcRbUbIawagagadbJbKbLbUaaaa
aacdbkcsagbladadadadalaKbPawbSadadaladadaocL
aaceaNcKagcUadaaaaamadaKawagbTbeaaaaaoaaaabo
aabebncVawaKaOaoaaaaalbWagagbXadaabvaoaoaacL
adadaGagdaaRapaSboaabecbagcfckalagclaabvaacL
arduasdcdddoalaladdladaGawcnaKalaaawaabvaaao
adagagawauagdpcMcDdrdsagbUcxagcyaacHaaboaabo
avawagcNauawagaUawcOagawagawcIadadadadadaocL
alagcPbjauagcgayazaAdfagcJagbUadcQdbcSalaaaa
cjaYdiagbwaCdjaDagaEbOagcTawawcWcXcYcZadaaaa
adadbeadalaladaDagaEadadaladadaladbeadadaaaa
aaaaaaaaaaaaaaaFababaaaaaaaaaaaaaaaaaaaaaaaa
"}
